11111111111
1C0000000C1
10011011001
1001C1P1001
10010101001
100101C1001
10010001001
1C0000000E1
11111111111
